3 3 3 3 3 3 3 3 3 3 3 3 3 3 3 3 3 3 3 3 3 3 3 3 3 3 3 3 3 3 3 3 3 3 3 3 3 3 3 3 3 3 3 3 3 3 3 3 3 3
3 3 3 3 3 3 3 3 3 3 3 3 3 3 3 3 3 3 3 3 3 3 3 3 3 3 3 3 3 3 3 3 3 3 3 3 3 3 3 3 3 3 3 3 3 3 3 3 3 3
3 3 3 3 3 3 3 3 3 3 3 3 3 3 3 3 3 3 3 3 3 3 3 3 3 3 3 3 3 3 3 3 3 3 3 3 3 3 3 3 3 3 3 3 3 3 3 3 3 3
3 3 3 3 3 3 3 3 3 3 3 3 3 3 3 3 3 3 3 3 3 3 3 3 3 3 3 3 3 3 3 3 3 3 3 3 3 3 3 3 3 3 3 3 3 3 3 3 3 3
3 3 3 3 3 3 3 3 3 3 3 3 3 3 3 3 3 3 3 3 3 3 3 3 3 3 3 3 3 3 3 3 3 3 3 3 3 3 3 3 3 3 3 3 3 3 3 3 3 3
3 3 3 3 3 3 3 3 3 3 3 3 3 3 3 3 3 3 3 3 3 3 3 3 3 3 3 3 3 3 3 3 3 3 3 3 3 3 3 3 3 3 3 3 3 3 3 3 3 3
3 3 3 3 3 3 3 3 0 0 0 0 0 0 0 0 0 0 0 0 0 0 0 0 0 0 0 8 8 8 6 6 6 6 6 6 6 6 6 6 6 6 3 3 3 3 3 3 3 3
3 3 3 3 3 3 3 3 0 0 0 0 0 0 0 0 0 0 0 0 0 0 0 0 0 0 0 0 8 8 8 6 6 8 8 8 6 8 8 8 8 6 3 3 3 3 3 3 3 3
3 3 3 3 3 3 3 3 0 0 0 0 0 0 0 0 0 0 0 0 0 0 0 0 0 0 0 0 0 2 8 6 8 8 6 8 6 6 8 6 8 6 3 3 3 3 3 3 3 3
3 3 3 3 3 3 3 3 0 0 0 3 3 3 3 3 0 0 0 0 0 0 0 0 0 0 0 0 0 0 8 6 8 6 6 8 8 6 8 6 8 6 3 3 3 3 3 3 3 3
3 3 3 3 3 3 3 3 0 0 3 3 3 3 3 3 0 0 0 0 0 0 0 0 0 0 0 0 0 0 8 6 8 6 8 6 8 6 8 6 8 6 3 3 3 3 3 3 3 3
3 3 3 3 3 3 3 3 0 0 3 3 3 2 2 2 2 2 2 2 2 2 2 2 2 2 2 2 2 2 2 2 2 2 2 6 8 6 8 6 8 6 3 3 3 3 3 3 3 3
3 3 3 3 3 3 3 3 0 0 0 2 2 2 5 5 0 0 0 0 0 0 0 0 0 0 0 0 0 0 0 0 0 0 2 6 8 6 8 6 8 6 3 3 3 3 3 3 3 3
3 3 3 3 3 3 3 3 0 5 5 2 5 5 5 5 5 5 0 5 5 5 5 5 5 0 5 5 0 5 5 5 0 0 2 6 8 8 8 6 9 6 3 3 3 3 3 3 3 3
3 3 3 3 3 3 3 3 0 5 5 2 5 5 5 5 5 5 5 5 5 5 5 5 5 5 5 5 5 5 5 5 5 0 2 2 6 6 6 6 6 8 3 3 3 3 3 3 3 3
3 3 3 3 3 3 3 3 0 0 5 2 5 5 5 0 5 5 5 5 5 5 5 5 5 5 5 5 5 5 5 0 5 5 0 2 0 0 8 8 8 8 3 3 3 3 3 3 3 3
3 3 3 3 3 3 3 3 0 0 0 2 0 5 5 0 5 5 5 5 5 5 5 0 0 5 5 5 5 5 5 5 5 5 0 2 0 0 0 0 8 8 3 3 3 3 3 3 3 3
3 3 3 3 3 3 3 3 0 0 0 2 0 5 5 5 5 0 0 0 0 0 0 0 0 0 0 0 0 5 5 5 5 5 0 2 0 0 0 0 0 0 3 3 3 3 3 3 3 3
3 3 3 3 3 3 3 3 0 0 0 2 0 0 5 5 5 5 0 3 3 3 3 3 3 3 3 3 0 0 5 5 5 0 0 2 0 0 0 0 0 0 3 3 3 3 3 3 3 3
3 3 3 3 3 3 3 3 0 0 0 2 0 0 0 5 5 5 0 3 7 7 7 7 7 7 7 3 0 0 0 5 5 0 0 2 0 0 0 0 0 0 3 3 3 3 3 3 3 3
3 3 3 3 3 3 3 3 0 0 0 2 0 0 0 5 5 5 0 3 7 9 9 4 9 9 7 3 0 5 5 5 5 5 0 2 0 0 0 0 0 0 3 3 3 3 3 3 3 3
3 3 3 3 3 3 3 3 0 0 0 2 0 0 0 5 5 5 0 3 7 9 9 9 9 9 7 3 0 5 5 5 5 5 0 2 0 0 0 0 0 0 3 3 3 3 3 3 3 3
3 3 3 3 3 3 3 3 0 0 0 2 0 0 5 5 5 5 0 3 7 9 9 9 9 9 7 3 0 5 5 5 5 5 0 2 0 0 0 0 0 0 3 3 3 3 3 3 3 3
3 3 3 3 3 3 3 3 0 0 0 2 2 0 5 5 5 5 0 3 7 9 9 9 9 9 7 3 0 5 5 5 5 5 0 2 0 0 0 0 0 0 3 3 3 3 3 3 3 3
3 3 3 3 3 3 3 3 0 0 0 0 2 0 5 5 5 5 0 3 7 7 7 9 7 7 7 3 0 5 5 5 5 5 0 2 0 0 0 0 0 0 3 3 3 3 3 3 3 3
3 3 3 3 3 3 3 3 0 0 0 0 2 0 5 5 5 0 0 3 3 3 3 2 3 3 3 3 0 0 5 5 5 5 0 2 0 0 0 0 0 0 3 3 3 3 3 3 3 3
3 3 3 3 3 3 3 3 0 0 0 0 2 0 5 5 5 5 5 0 0 0 0 2 0 0 0 0 0 5 5 5 5 5 0 2 0 0 0 0 0 0 3 3 3 3 3 3 3 3
3 3 3 3 3 3 3 3 0 0 0 0 2 0 5 5 5 5 5 0 0 0 0 2 0 5 5 5 5 5 5 5 5 5 0 2 0 0 0 0 0 0 3 3 3 3 3 3 3 3
3 3 3 3 3 3 3 3 0 0 0 0 2 0 5 5 5 5 5 5 5 0 0 2 0 5 5 0 5 5 5 5 5 5 0 2 0 0 0 0 0 0 3 3 3 3 3 3 3 3
3 3 3 3 3 3 3 3 0 0 0 0 2 0 5 5 5 5 5 5 5 0 0 2 0 5 5 5 5 5 5 5 5 0 0 2 0 0 0 0 0 0 3 3 3 3 3 3 3 3
3 3 3 3 3 3 3 3 0 0 0 0 2 0 0 5 5 5 5 5 5 0 0 2 0 5 5 5 5 5 5 0 0 0 0 2 0 0 0 0 0 0 3 3 3 3 3 3 3 3
3 3 3 3 3 3 3 3 0 0 0 0 2 0 0 0 0 0 0 0 0 0 0 2 0 0 0 0 0 0 0 0 0 0 0 2 0 0 0 0 0 0 3 3 3 3 3 3 3 3
3 3 3 3 3 3 3 3 0 0 0 0 2 2 2 2 2 2 2 2 2 2 2 2 2 2 2 2 2 2 2 2 2 2 2 2 0 0 0 0 0 0 3 3 3 3 3 3 3 3
3 3 3 3 3 3 3 3 0 0 0 0 0 0 0 0 0 0 0 0 0 0 0 2 0 0 0 0 0 0 0 0 0 0 0 2 0 0 0 0 0 0 3 3 3 3 3 3 3 3
3 3 3 3 3 3 3 3 0 0 0 0 0 0 0 0 0 0 0 0 0 0 0 2 0 0 0 0 0 0 0 0 0 0 0 2 0 0 0 0 0 0 3 3 3 3 3 3 3 3
3 3 3 3 3 3 3 3 0 0 0 0 0 0 0 0 0 0 0 0 0 0 0 2 0 0 0 0 0 0 0 0 0 0 0 2 0 0 0 0 0 0 3 3 3 3 3 3 3 3
3 3 3 3 3 3 3 3 0 0 0 0 0 0 0 0 0 0 0 0 0 0 2 2 0 0 0 0 0 0 0 0 0 0 0 2 0 0 0 0 0 0 3 3 3 3 3 3 3 3
3 3 3 3 3 3 3 3 0 0 0 0 0 0 0 0 0 0 0 0 0 2 2 0 0 0 0 0 0 0 0 0 0 0 0 2 0 0 0 0 0 0 3 3 3 3 3 3 3 3
3 3 3 3 3 3 3 3 0 0 0 0 0 0 0 0 0 0 0 0 2 2 0 0 0 0 0 0 0 0 0 0 0 0 0 2 0 0 0 0 0 0 3 3 3 3 3 3 3 3
3 3 3 3 3 3 3 3 0 0 0 0 0 0 0 0 0 0 0 2 2 0 0 0 0 0 0 0 0 0 0 2 2 2 2 2 2 2 2 2 0 0 3 3 3 3 3 3 3 3
3 3 3 3 3 3 3 3 0 0 0 2 2 2 2 2 2 2 2 2 0 0 0 0 0 0 0 0 0 0 0 0 0 0 0 2 0 0 0 0 0 0 3 3 3 3 3 3 3 3
3 3 3 3 3 3 3 3 0 0 0 0 0 0 0 0 0 0 0 0 0 0 0 0 0 0 0 0 0 0 0 0 0 0 0 2 0 0 0 0 0 0 3 3 3 3 3 3 3 3
3 3 3 3 3 3 3 3 0 0 0 0 0 0 0 0 0 0 0 0 0 0 0 0 0 0 0 0 0 0 0 0 0 0 0 0 0 0 0 0 0 0 3 3 3 3 3 3 3 3
3 3 3 3 3 3 3 3 0 0 0 0 0 0 0 0 0 0 0 0 0 0 0 0 0 0 0 0 0 0 0 0 0 0 0 0 0 0 0 0 0 0 3 3 3 3 3 3 3 3
3 3 3 3 3 3 3 3 3 3 3 3 3 3 3 3 3 3 3 3 3 3 3 3 3 3 3 3 3 3 3 3 3 3 3 3 3 3 3 3 3 3 3 3 3 3 3 3 3 3
3 3 3 3 3 3 3 3 3 3 3 3 3 3 3 3 3 3 3 3 3 3 3 3 3 3 3 3 3 3 3 3 3 3 3 3 3 3 3 3 3 3 3 3 3 3 3 3 3 3
3 3 3 3 3 3 3 3 3 3 3 3 3 3 3 3 3 3 3 3 3 3 3 3 3 3 3 3 3 3 3 3 3 3 3 3 3 3 3 3 3 3 3 3 3 3 3 3 3 3
3 3 3 3 3 3 3 3 3 3 3 3 3 3 3 3 3 3 3 3 3 3 3 3 3 3 3 3 3 3 3 3 3 3 3 3 3 3 3 3 3 3 3 3 3 3 3 3 3 3
3 3 3 3 3 3 3 3 3 3 3 3 3 3 3 3 3 3 3 3 3 3 3 3 3 3 3 3 3 3 3 3 3 3 3 3 3 3 3 3 3 3 3 3 3 3 3 3 3 3
3 3 3 3 3 3 3 3 3 3 3 3 3 3 3 3 3 3 3 3 3 3 3 3 3 3 3 3 3 3 3 3 3 3 3 3 3 3 3 3 3 3 3 3 3 3 3 3 3 3