3 3 3 3 3 3 3 3 3 3 3 3 3 3 3 3 3 3 3 3 3 3 3 3 3 3 3 3 3 3 3 3 3 3 3 3 3 3 3 3 3 3 3 3 3 3 3 3 3 3
3 3 3 3 3 3 3 3 3 3 3 3 3 3 3 3 3 3 3 3 3 3 3 3 3 3 3 3 3 3 3 3 3 3 3 3 3 3 3 3 3 3 3 3 3 3 3 3 3 3
3 3 3 3 3 3 3 3 3 3 3 3 3 3 3 3 3 3 3 3 3 3 3 3 3 3 3 3 3 3 3 3 3 3 3 3 3 3 3 3 3 3 3 3 3 3 3 3 3 3
3 3 3 3 3 3 3 3 3 3 3 3 3 3 3 3 3 3 3 3 3 3 3 3 3 3 3 3 3 3 3 3 3 3 3 3 3 3 3 3 3 3 3 3 3 3 3 3 3 3
3 3 3 3 3 3 3 3 3 3 3 3 3 3 3 3 3 3 3 3 3 3 3 3 3 3 3 3 3 3 3 3 3 3 3 3 3 3 3 3 3 3 3 3 3 3 3 3 3 3
3 3 3 3 3 3 3 3 3 3 3 3 3 3 3 3 3 3 3 3 3 3 3 3 3 3 3 3 3 3 3 3 3 3 3 3 3 3 3 3 3 3 3 3 3 3 3 3 3 3
3 3 3 3 3 3 3 3 0 0 0 0 0 0 0 0 0 0 0 0 0 0 0 0 0 0 0 2 2 2 6 6 6 6 6 6 6 6 6 6 6 6 3 3 3 3 3 3 3 3
3 3 3 3 3 3 3 3 0 0 0 0 0 0 0 0 0 0 0 0 0 0 0 0 0 0 0 0 2 2 2 6 6 2 2 2 6 2 2 2 2 6 3 3 3 3 3 3 3 3
3 3 3 3 3 3 3 3 0 0 0 0 0 0 0 0 0 0 0 0 0 0 0 0 0 0 0 0 0 2 2 6 2 2 6 2 6 6 2 6 2 6 3 3 3 3 3 3 3 3
3 3 3 3 3 3 3 3 0 0 0 3 3 3 3 3 4 0 0 0 0 0 0 0 0 0 0 0 0 0 2 6 2 6 6 2 2 6 2 6 2 6 3 3 3 3 3 3 3 3
3 3 3 3 3 3 3 3 0 0 3 3 3 3 3 3 4 0 0 0 0 0 0 0 0 0 0 0 0 0 2 6 2 6 2 6 2 6 2 6 2 6 3 3 3 3 3 3 3 3
3 3 3 3 3 3 3 3 0 0 3 3 3 4 4 4 4 2 2 2 2 2 2 2 2 2 2 2 2 2 2 2 2 2 2 6 2 6 2 6 2 6 3 3 3 3 3 3 3 3
3 3 3 3 3 3 3 3 0 0 0 0 0 0 0 0 0 0 0 0 0 0 0 0 0 0 0 0 0 0 0 0 0 0 0 6 2 6 2 6 2 6 3 3 3 3 3 3 3 3
3 3 3 3 3 3 3 3 0 0 0 0 0 0 0 0 0 0 0 0 0 0 0 0 0 0 0 0 0 0 0 0 0 0 0 6 2 2 2 6 4 6 3 3 3 3 3 3 3 3
3 3 3 3 3 3 3 3 0 0 0 0 0 0 0 0 0 0 0 0 0 0 0 0 0 0 0 0 0 0 0 0 0 0 0 2 6 6 6 6 6 2 3 3 3 3 3 3 3 3
3 3 3 3 3 3 3 3 0 0 0 0 0 0 0 0 0 0 0 0 0 0 0 0 0 0 0 0 0 0 0 0 0 0 0 2 0 0 2 2 2 2 3 3 3 3 3 3 3 3
3 3 3 3 3 3 3 3 0 0 0 0 0 0 0 0 0 0 0 0 0 0 0 0 0 0 0 0 0 0 0 0 0 0 0 2 0 0 0 0 2 2 3 3 3 3 3 3 3 3
3 3 3 3 3 3 3 3 0 0 0 2 0 0 0 0 0 0 0 0 0 0 0 0 0 0 0 0 0 0 0 0 0 0 0 2 0 0 0 0 0 0 3 3 3 3 3 3 3 3
3 3 3 3 3 3 3 3 0 0 0 2 0 0 5 5 5 5 0 3 3 3 3 3 3 3 3 3 0 0 0 0 0 0 0 2 0 0 0 0 0 0 3 3 3 3 3 3 3 3
3 3 3 3 3 3 3 3 0 0 0 2 0 0 0 5 5 5 0 3 7 7 7 7 7 7 7 3 0 0 0 0 0 0 0 2 0 0 0 0 0 0 3 3 3 3 3 3 3 3
3 3 3 3 3 3 3 3 0 0 0 2 0 0 0 5 5 5 0 3 7 2 2 2 2 2 7 3 0 0 0 1 2 3 0 2 0 0 0 0 0 0 3 3 3 3 3 3 3 3
3 3 3 3 3 3 3 3 0 0 0 2 0 0 0 5 5 5 0 3 7 2 2 2 2 2 7 3 0 0 4 5 6 7 0 2 0 0 0 0 0 0 3 3 3 3 3 3 3 3
3 3 3 3 3 3 3 3 0 0 0 2 0 0 5 5 5 5 0 3 7 2 2 2 2 2 7 3 0 0 0 0 0 0 0 2 0 0 0 0 0 0 3 3 3 3 3 3 3 3
3 3 3 3 3 3 3 3 0 0 0 2 2 0 5 5 5 5 0 3 7 2 2 2 2 2 7 3 0 5 5 5 5 5 0 2 0 0 0 0 0 0 3 3 3 3 3 3 3 3
3 3 3 3 3 3 3 3 0 0 0 0 2 0 5 5 5 5 0 3 7 7 7 2 7 7 7 3 0 5 5 5 5 5 0 2 0 0 0 0 0 0 3 3 3 3 3 3 3 3
3 3 3 3 3 3 3 3 0 0 0 0 2 0 5 5 5 0 0 3 3 3 3 2 3 3 3 3 0 0 5 5 5 5 0 2 0 0 0 0 0 0 3 3 3 3 3 3 3 3
3 3 3 3 3 3 3 3 0 0 0 0 2 0 5 5 5 5 0 0 0 0 0 2 0 0 0 0 0 5 5 5 5 5 0 2 0 0 0 0 0 0 3 3 3 3 3 3 3 3
3 3 3 3 3 3 3 3 0 0 0 0 2 0 5 5 5 5 5 0 0 0 0 2 0 5 5 5 5 5 5 5 5 5 0 2 0 0 0 0 0 0 3 3 3 3 3 3 3 3
3 3 3 3 3 3 3 3 0 0 0 0 2 0 5 5 5 5 5 5 5 0 0 2 0 5 5 5 5 5 5 5 5 5 0 2 0 0 0 0 0 0 3 3 3 3 3 3 3 3
3 3 3 3 3 3 3 3 0 0 0 0 2 0 5 5 5 5 5 5 5 5 0 2 0 5 5 5 5 5 5 5 5 0 0 2 0 0 0 0 0 0 3 3 3 3 3 3 3 3
3 3 3 3 3 3 3 3 0 0 0 0 2 0 0 5 5 5 5 5 5 5 0 2 0 5 5 5 5 5 5 0 0 0 0 2 0 0 0 0 0 0 3 3 3 3 3 3 3 3
3 3 3 3 3 3 3 3 0 0 0 0 2 0 0 0 0 0 0 0 0 0 0 2 0 0 0 0 0 0 0 0 0 0 0 2 0 0 0 0 0 0 3 3 3 3 3 3 3 3
3 3 3 3 3 3 3 3 0 0 0 0 2 2 2 2 2 2 2 2 2 2 2 2 2 2 2 2 2 2 2 2 2 2 2 2 0 0 0 0 0 0 3 3 3 3 3 3 3 3
3 3 3 3 3 3 3 3 0 0 0 0 0 0 0 0 0 0 0 0 0 0 0 2 0 0 0 0 0 0 0 0 0 0 0 2 0 0 0 0 0 0 3 3 3 3 3 3 3 3
3 3 3 3 3 3 3 3 0 0 0 0 0 0 0 0 0 0 0 0 0 0 0 2 0 0 0 0 0 0 0 0 0 0 0 2 0 0 0 0 0 0 3 3 3 3 3 3 3 3
3 3 3 3 3 3 3 3 0 0 0 0 0 0 0 0 0 0 0 0 0 0 0 2 0 0 0 0 0 0 0 0 0 0 0 2 0 0 0 0 0 0 3 3 3 3 3 3 3 3
3 3 3 3 3 3 3 3 0 0 0 0 0 0 0 0 0 0 0 0 0 0 2 2 0 0 0 0 0 0 0 0 0 0 0 2 0 0 0 0 0 0 3 3 3 3 3 3 3 3
3 3 3 3 3 3 3 3 0 0 0 0 0 0 0 0 0 0 0 0 0 2 2 0 0 0 0 0 0 0 0 0 0 0 0 2 0 0 0 0 0 0 3 3 3 3 3 3 3 3
3 3 3 3 3 3 3 3 0 0 0 0 0 0 0 0 0 0 0 0 2 2 0 0 0 0 0 0 0 0 0 0 0 0 0 2 0 0 0 0 0 0 3 3 3 3 3 3 3 3
3 3 3 3 3 3 3 3 0 0 0 0 0 0 0 0 0 0 0 2 2 0 0 0 0 0 0 0 0 0 0 2 2 2 2 2 2 2 2 2 0 0 3 3 3 3 3 3 3 3
3 3 3 3 3 3 3 3 0 0 0 2 2 2 2 2 2 2 2 2 0 0 0 0 0 0 0 0 0 0 0 0 0 0 0 2 0 0 0 0 0 0 3 3 3 3 3 3 3 3
3 3 3 3 3 3 3 3 0 0 0 0 0 0 0 0 0 0 0 0 0 0 0 0 0 0 0 0 0 0 0 0 0 0 0 2 0 0 0 0 0 0 3 3 3 3 3 3 3 3
3 3 3 3 3 3 3 3 0 0 0 0 0 0 0 0 0 0 0 0 0 0 0 0 0 0 0 0 0 0 0 0 0 0 0 0 0 0 0 0 0 0 3 3 3 3 3 3 3 3
3 3 3 3 3 3 3 3 0 0 0 0 0 0 0 0 0 0 0 0 0 0 0 0 0 0 0 0 0 0 0 0 0 0 0 0 0 0 0 0 0 0 3 3 3 3 3 3 3 3
3 3 3 3 3 3 3 3 3 3 3 3 3 3 3 3 3 3 3 3 3 3 3 3 3 3 3 3 3 3 3 3 3 3 3 3 3 3 3 3 3 3 3 3 3 3 3 3 3 3
3 3 3 3 3 3 3 3 3 3 3 3 3 3 3 3 3 3 3 3 3 3 3 3 3 3 3 3 3 3 3 3 3 3 3 3 3 3 3 3 3 3 3 3 3 3 3 3 3 3
3 3 3 3 3 3 3 3 3 3 3 3 3 3 3 3 3 3 3 3 3 3 3 3 3 3 3 3 3 3 3 3 3 3 3 3 3 3 3 3 3 3 3 3 3 3 3 3 3 3
3 3 3 3 3 3 3 3 3 3 3 3 3 3 3 3 3 3 3 3 3 3 3 3 3 3 3 3 3 3 3 3 3 3 3 3 3 3 3 3 3 3 3 3 3 3 3 3 3 3
3 3 3 3 3 3 3 3 3 3 3 3 3 3 3 3 3 3 3 3 3 3 3 3 3 3 3 3 3 3 3 3 3 3 3 3 3 3 3 3 3 3 3 3 3 3 3 3 3 3
3 3 3 3 3 3 3 3 3 3 3 3 3 3 3 3 3 3 3 3 3 3 3 3 3 3 3 3 3 3 3 3 3 3 3 3 3 3 3 3 3 3 3 3 3 3 3 3 3 3